1111111111111111111111111111111111111111
1CCCCCCCCCCCCCCCCCCCCCCCCP000000000000X1
1C1C1111111111111111111111111111111111C1
1C1CCCCCCCCCCCCCCCCCCCCCCCCCCCCCCCCCCCC1
1C1C1C111111111111111111111111111111C1C1
1C1C1CCCCCCCCCCCCCCCCCCCCCCCCCCCCCCCC1C1
1C1C1C1C11111111111111111111111111C1C1C1
1C1C1C1CCCCCCCCCCCCCCCCCCCCCCCCCCCC1C1C1
1C1C1C1C1C1111111111111111111111C1C1C1C1
1C1C1C1C1CCCCCCCCCCCCCCCCCCCCCCCC1C1C1C1
1C1C1C1C1C1111111111111111111111C1C1C1C1
1C1C1C1C1CE1X1X1X1X1X1X1X1X1X1X1C1C1C1C1
1C1C1C1C1C1111111111111111111111C1C1C1C1
1C1C1C1CCCCCCCCCCCCCCCCCCCCCCCCCC1C1C1C1
1C1C1C1C111111111111111111111111C1C1C1C1
1C1C1CCCCCCCCCCCCCCCCCCCCCCCCCCCCCC1C1C1
1C1C1C1111111111111111111111111111C1C1C1
1C1CCCCCCCCCCCCCCCCCCCCCCCCCCCCCCCCCC1C1
1C1C11111111111111111111111111111111C1C1
1CCCCCCCCCCCCCCCCCCCCCCCCCCCCCCCCCCCCCC1
1111111111111111111111111111111111111111