11111111111111111111
1C0000C0010000000101
100P00000100C00000C1
10000000010000000011
100000000C000000E001
11111111111111111111