1111111111111111111111111111111111111111
100C000000000000000X00000000000000000001
100000000000000000000000X000000000000001
111111000000X000000000000000000000000001
100000000000000000000000X000000000000001
1000000000000000000000000000000000000001
1000000000000000P00000000000000000000001
10CC000000000000000000000000000000000001
10000000000000000000000000X0000000000001
100000000000X000000000000000000000000001
100000000000000000C000000000000000000001
100000000000000000C000000000000000000001
1000C0000000000000C00000000X000000000001
1111100000000000000000000001111111100001
100000000000000000000000000000C111111111
1111101111001111110X01111111111111111111
1111101110011111110011111111111111111111
100C000001C10000X00000000000000111111111
1000000001E100000X000000X000000111111111
1111111111111111111111111111111000000001
1111111111111111111111111111111111111111