1111111111111111111111111111111111111111
1C00000000000000000000000000000000000001
100000000000000000X000000000000000000001
1000000000000000000000000000000000000001
100P000000011111100011111110000000000001
111111110001C00C100010000010001111110001
1000000000010CC01000000000100000CX0100C1
100000000000000010C0100000100000C0010001
10110001100000001111100000100000C001C001
101000001001000000CCC00000100000C0X10001
101C000C1001000000CXC00000000000C00100C1
10100X001001000000CCC00000000000CCC10X01
101110011001111111111100000000000001C001
1000000000000000000000000000111111110001
10110011100000000CCCCCC000011C0000000001
101C0000100000000C0XX0C00001CC0000000001
10100X00100000000CCCCCC0000100X011111011
101C000C10000000000000000001000000000001
10110001100000001111111111110000100X0001
10000X0000000000CCCCCCCCCCCC00001000E001
1111111111111111111111111111111111111111